70 95 49 48 80 47 65 42 21 59 96 1 93 55 44 0 98 67 40 88 83 52 64 6 79 11 90 63 50 62 38 30 2 22 71 14 78 18 99 73 56 20 51 81 28 45 10 53 32 69 72 43 92 33 8 3 7 23 24 91 41 74 35 61 26 75 9 27 16 85 25 77 39 4 17 12 84 68 60 13 97 37 87 66 31 34 82 58 86 29 36 57 15 5 54 46 89 19 94 76 
6 84 19 33 73 83 2 23 44 22 59 46 88 66 77 89 12 3 4 30 10 97 11 85 98 5 58 0 13 17 49 93 64 41 34 27 31 92 53 63 90 38 70 56 95 45 51 81 24 47 50 18 52 40 60 21 65 55 86 43 14 62 69 74 16 9 82 67 32 20 42 25 8 72 29 35 78 26 7 79 80 75 68 48 76 37 36 71 91 28 94 54 61 15 1 87 39 96 57 99 
47 33 22 17 9 49 69 59 90 20 86 29 62 15 40 60 35 82 48 89 50 95 2 28 55 68 32 73 44 85 51 1 66 74 42 36 23 76 38 65 26 6 71 46 41 0 18 63 77 79 57 64 70 58 81 10 34 53 43 88 5 87 96 11 13 78 75 39 67 37 8 84 4 94 30 27 72 80 3 16 45 99 83 31 14 7 61 98 52 97 91 92 54 21 93 56 12 19 24 25 
84 46 43 78 85 63 52 75 37 81 51 71 95 30 7 87 56 20 92 24 28 41 44 76 98 10 14 66 17 49 29 31 27 96 73 40 89 1 34 23 62 42 83 72 60 0 22 21 94 19 33 61 90 93 12 69 16 26 13 5 65 59 80 79 77 2 57 3 25 82 18 45 91 15 58 68 97 11 70 99 36 50 9 32 35 74 55 4 88 48 86 6 8 64 47 38 67 53 39 54 
61 71 59 19 53 9 84 48 22 72 3 73 12 77 49 57 51 67 79 85 42 80 98 64 81 10 29 56 37 15 6 76 97 33 62 87 52 83 16 24 2 5 21 20 44 58 32 75 47 30 7 96 31 35 91 13 4 18 69 68 26 43 89 14 92 34 78 63 74 86 88 36 8 55 54 28 46 50 66 95 82 40 93 65 23 0 39 1 99 90 94 45 70 41 38 60 17 27 25 11 
1 34 94 82 90 45 76 3 87 86 92 96 42 91 93 21 81 78 9 28 50 75 69 39 65 83 30 6 59 14 85 46 43 58 16 79 74 25 66 7 95 38 8 41 52 19 49 35 88 84 22 77 17 13 27 73 29 40 10 11 18 72 56 48 61 62 20 24 47 70 53 26 99 36 54 97 89 0 68 12 5 64 44 63 60 80 33 31 32 15 37 57 51 67 71 55 98 2 4 23 
61 31 6 24 99 63 64 78 21 12 79 13 45 16 46 62 77 93 73 50 22 66 75 9 47 1 51 17 80 76 84 94 57 98 59 97 86 56 71 42 91 87 33 11 70 19 55 38 43 30 82 89 67 15 29 96 2 85 53 4 34 81 40 39 5 72 14 92 35 52 25 28 41 18 10 44 69 32 74 54 60 23 48 49 8 37 20 68 58 95 3 36 83 27 0 7 26 90 65 88 
18 60 26 31 55 50 92 16 75 65 1 96 0 41 2 64 99 30 44 89 11 43 82 20 5 73 37 69 71 34 19 54 33 3 17 85 87 80 25 59 47 52 36 95 94 81 93 22 9 29 91 40 86 88 28 78 61 7 21 97 70 15 67 62 63 45 48 76 58 42 12 77 32 4 68 23 6 8 53 90 74 79 66 24 38 49 10 57 56 83 72 46 27 13 84 51 35 14 39 98 
66 41 94 73 35 61 18 77 80 45 21 51 89 50 85 8 99 78 52 93 36 71 26 6 47 13 37 69 68 31 1 46 32 57 54 56 72 90 40 58 22 55 38 81 15 60 14 23 49 17 43 59 28 10 87 29 74 19 98 84 82 3 39 53 0 67 63 11 4 20 83 7 88 2 30 96 27 24 12 25 76 5 70 95 62 48 86 42 92 9 91 79 64 16 97 65 34 44 75 33 
39 51 99 38 88 6 56 91 95 10 94 83 8 5 64 37 57 19 80 54 72 14 65 75 50 18 41 85 32 76 47 1 60 63 42 35 78 81 9 7 55 12 29 36 90 70 86 15 61 45 11 31 27 68 62 24 73 98 66 48 0 97 22 16 82 44 46 71 52 33 21 30 17 26 23 3 43 4 67 40 77 92 79 53 69 59 25 20 2 87 74 96 84 58 13 49 93 34 89 28 
