99 98 97 96 5 94 93 92 91 84 89 88 87 86 85 90 83 82 81 80 79 78 77 76 75 74 73 72 71 70 69 68 67 66 65 64 63 62 61 60 59 58 57 56 55 54 53 52 51 50 49 48 47 46 45 44 43 42 41 40 39 38 37 36 35 34 33 32 31 30 29 28 27 26 25 24 23 22 21 20 19 18 17 16 15 14 13 12 11 10 9 8 7 6 95 4 3 2 1 0 
99 98 97 96 95 94 93 92 91 90 89 88 14 86 85 84 83 82 81 80 79 78 77 76 75 74 52 72 71 70 69 68 67 66 65 64 63 62 61 60 59 58 57 56 55 54 53 73 51 50 49 48 47 46 45 44 43 42 41 40 39 38 37 36 35 34 33 32 31 30 29 28 27 26 25 24 23 22 21 20 19 18 17 16 15 87 13 12 11 10 9 8 7 6 5 4 3 2 1 0 
99 98 97 96 95 94 93 92 91 90 89 88 87 86 85 84 83 82 81 80 79 78 77 76 75 74 73 72 71 70 69 68 67 66 65 64 63 29 61 60 59 58 57 56 49 54 53 52 51 50 55 48 47 46 45 44 43 42 41 40 39 38 37 36 35 34 33 32 31 30 62 28 27 26 25 24 23 22 21 20 19 18 17 16 15 14 13 12 11 10 9 8 7 6 5 4 3 2 1 0 
99 98 97 96 95 94 93 92 91 90 89 88 87 86 85 84 83 82 81 80 79 78 77 76 15 74 73 72 71 70 16 68 67 66 65 64 63 62 61 60 59 58 57 56 55 54 53 52 51 50 49 48 47 46 45 44 43 42 41 40 39 38 37 36 35 34 33 32 31 30 29 28 27 26 25 24 23 22 21 20 19 18 17 69 75 14 13 12 11 10 9 8 7 6 5 4 3 2 1 0 
99 98 97 96 95 94 93 92 91 90 89 88 87 86 85 84 83 82 81 80 79 78 23 76 75 74 73 72 71 70 69 68 67 66 65 64 63 62 61 10 59 58 57 56 55 54 53 52 51 50 49 48 47 46 45 44 43 42 41 40 39 38 37 36 35 34 33 32 31 30 29 28 27 26 25 24 77 22 21 20 19 18 17 16 15 14 13 12 11 60 9 8 7 6 5 4 3 2 1 0 
99 98 97 96 95 94 93 92 50 90 89 88 87 86 85 84 83 82 81 80 79 78 77 76 65 74 73 72 71 70 69 68 67 66 75 64 63 62 61 60 59 58 57 56 55 54 53 52 51 91 49 48 47 46 45 44 43 42 41 40 39 38 37 36 35 34 33 32 31 30 29 28 27 26 25 24 23 22 21 20 19 18 17 16 15 14 13 12 11 10 9 8 7 6 5 4 3 2 1 0 
99 98 97 96 95 40 93 92 91 90 89 88 87 86 85 84 83 82 81 80 79 78 77 76 75 74 73 72 71 70 69 68 67 66 65 64 63 62 61 60 59 58 57 56 55 54 53 52 51 50 49 48 47 46 45 44 43 42 41 94 39 15 37 36 35 34 33 32 31 30 29 28 27 26 25 24 23 22 21 20 19 18 17 16 38 14 13 12 11 10 9 8 7 6 5 4 3 2 1 0 
99 98 97 96 95 94 93 92 91 33 89 88 87 86 85 84 83 82 81 80 79 78 77 76 75 74 73 72 71 70 69 68 67 66 65 64 63 62 61 60 59 58 57 56 55 54 53 52 51 50 49 48 47 46 45 44 43 42 41 40 39 38 37 36 35 34 90 32 31 26 29 28 27 30 25 24 23 22 21 20 19 18 17 16 15 14 13 12 11 10 9 8 7 6 5 4 3 2 1 0 
99 98 97 96 95 94 67 92 91 90 89 88 87 86 85 84 83 82 81 80 79 78 77 76 75 74 73 72 71 70 69 68 93 66 65 64 63 62 61 60 59 58 57 56 55 54 53 52 51 50 49 48 47 46 45 44 43 42 16 40 39 38 37 36 35 34 33 32 31 30 29 28 27 26 25 24 23 22 21 20 19 18 17 41 15 14 13 12 11 10 9 8 7 6 5 4 3 2 1 0 
99 98 97 96 95 94 93 92 91 90 89 88 87 86 85 84 83 82 81 80 61 78 77 76 75 74 73 72 40 70 69 68 67 66 65 64 63 62 79 60 59 58 57 56 55 54 53 52 51 50 49 48 47 46 45 44 43 42 41 71 39 38 37 36 35 34 33 32 31 30 29 28 27 26 25 24 23 22 21 20 19 18 17 16 15 14 13 12 11 10 9 8 7 6 5 4 3 2 1 0 
