41 75 67 0 14 73 95 31 69 59 90 60 61 86 74 6 83 65 55 20 37 48 89 71 77 24 44 93 64 56 99 19 29 15 35 50 11 58 5 38 45 42 76 79 23 32 40 2 52 4 72 36 66 97 22 49 8 91 47 98 9 27 57 94 82 62 53 70 26 12 63 68 46 13 51 25 30 92 1 80 28 39 7 3 88 78 33 21 87 84 54 10 34 16 85 43 81 17 18 96 
33 53 51 57 62 63 88 78 9 11 38 7 5 41 59 47 50 43 92 12 67 93 96 69 66 26 42 0 24 28 22 86 97 1 18 14 37 23 36 40 79 49 19 8 6 98 46 39 34 27 32 82 64 80 3 94 20 77 52 70 31 15 61 60 25 13 71 99 65 76 30 21 68 87 44 73 72 81 4 91 16 35 89 10 75 29 85 2 45 48 83 84 54 90 74 58 17 56 95 55 
45 62 67 92 72 2 9 55 41 52 96 80 42 83 34 29 54 99 13 16 69 27 37 5 91 22 7 84 97 43 71 49 65 40 24 53 12 38 10 1 82 60 32 63 95 36 31 25 61 59 90 8 33 93 28 70 58 30 86 44 18 0 94 81 21 15 79 88 46 23 47 78 35 6 64 75 50 68 11 4 74 85 19 14 51 76 39 66 98 77 56 73 87 89 3 57 26 17 20 48 
55 36 24 14 92 63 9 56 52 54 42 73 59 38 83 12 23 99 0 18 43 50 62 65 2 41 75 44 70 91 87 48 69 89 88 79 27 49 93 40 16 20 13 78 95 34 61 98 25 46 53 97 21 5 96 10 26 6 15 84 19 57 28 76 1 31 58 86 64 60 45 3 47 35 37 33 32 94 68 30 7 22 17 85 82 29 51 74 66 11 72 81 67 90 8 4 77 39 71 80 
18 59 53 14 96 5 50 75 24 37 10 44 1 41 58 23 94 78 30 48 9 52 8 25 73 40 35 51 6 79 45 21 87 36 72 17 81 43 27 29 91 26 82 55 34 19 77 74 54 76 80 99 85 71 16 13 83 42 28 22 39 4 86 12 93 7 2 70 56 15 98 64 69 95 60 3 32 90 49 62 57 84 63 92 38 88 0 89 66 65 67 33 61 47 20 11 46 68 97 31 
42 51 66 89 85 45 50 37 8 91 70 74 3 72 39 67 24 61 2 80 17 11 6 4 35 78 23 68 79 60 16 56 86 97 15 30 7 94 59 57 38 21 44 20 65 98 29 5 62 96 46 27 36 9 12 18 82 33 49 71 58 47 26 31 34 83 1 90 81 95 48 84 10 41 55 76 52 75 0 32 73 19 88 93 13 77 69 87 25 99 54 43 40 14 92 63 64 53 28 22 
12 46 7 56 96 19 69 94 1 23 29 73 42 77 6 49 64 48 17 95 35 90 79 58 47 27 43 97 33 40 31 99 16 85 41 24 74 66 83 52 87 53 11 61 86 92 25 37 28 4 57 55 20 59 93 5 75 22 38 72 21 84 32 13 9 0 10 88 80 54 89 45 15 76 81 2 60 78 51 50 65 63 67 3 26 39 14 8 62 18 98 34 30 91 71 68 70 36 44 82 
6 52 28 86 78 37 70 84 71 89 65 73 23 48 10 18 54 94 14 90 44 25 0 64 26 75 55 63 45 21 20 60 40 49 95 11 99 47 61 9 19 13 67 29 41 5 72 39 66 32 7 85 12 82 36 91 83 3 92 16 62 30 35 93 87 69 79 2 80 38 81 43 88 24 53 8 51 33 50 4 96 98 76 22 74 15 59 57 27 68 1 42 56 34 31 17 58 97 77 46 
37 8 48 32 1 56 63 83 74 93 18 73 72 9 44 62 11 12 78 80 15 67 10 99 90 95 3 81 66 97 54 0 21 50 76 52 94 79 41 31 69 4 17 45 19 58 35 36 59 24 14 85 43 23 29 77 34 60 5 64 68 30 71 40 51 16 91 84 13 75 57 88 33 86 98 22 7 42 39 96 20 61 25 89 47 38 87 2 26 82 28 55 70 49 92 65 53 27 46 6 
53 47 69 9 33 26 85 50 92 28 7 72 76 36 27 52 15 20 80 14 49 51 57 23 22 93 13 25 81 87 63 98 77 64 24 58 18 55 12 75 5 62 10 3 11 0 4 94 29 30 84 99 73 59 71 66 6 74 79 44 35 91 41 19 56 46 48 40 96 38 86 95 90 82 83 37 21 78 60 32 88 65 8 39 68 97 54 45 16 1 2 17 34 43 31 67 42 70 61 89 
