0 9 2 3 4 5 6 1 7 8 
3 0 1 2 8 4 5 6 7 9 
0 1 6 2 5 3 4 7 8 9 
0 8 1 2 3 4 5 7 6 9 
1 2 0 4 5 6 3 7 8 9 
