9 6 4 3 8 2 0 7 5 1 
5 9 8 4 3 1 7 6 0 2 
6 9 2 8 1 7 5 4 0 3 
8 9 4 7 3 0 6 5 2 1 
6 4 9 8 3 2 0 7 5 1 
