4 3 0 5 1 8 7 9 6 2 
4 8 1 3 2 7 6 0 9 5 
9 6 0 4 1 8 2 7 3 5 
5 8 6 1 9 3 7 2 0 4 
8 2 7 9 0 3 6 4 1 5 
